1,1,1,1,1,1,1,1,1,1
1,1,1,1,1,1,1,1,1,1
1,1,1,1,1,1,1,1,1,1
1,1,1,109,111,111,110,1,1,1
1,1,1,138,96,96,138,1,1,1
1,1,1,138,96,96,138,1,1,1
1,1,1,136,111,111,137,1,1,1
1,1,1,1,1,1,1,1,1,1
1,1,1,1,1,1,1,1,1,1
1,1,1,1,1,1,1,1,1,1