1,1,1,1,1,1,1,1,1,1
1,1,1,1,1,1,1,1,1,1
1,1,1,1,1,1,1,1,1,1
1,1,1,109,111,111,110,1,1,1
1,1,1,115,96,96,138,1,1,1
1,1,1,96,96,96,96,1,1,1
1,1,1,141,96,96,138,1,1,1
1,1,1,136,111,111,137,1,1,1
1,1,1,1,1,1,1,1,1,1
1,1,1,1,1,1,1,1,1,1